#####  #####
#####8     #
####   ##  #
 OO# # ## ##
     X  #X##
#  # #    ##
####   ##X##
#########  #
####O      #
############
############
############
